You are a small ten-year-old having a sleep over at grandma's house. You helped her make homemade chocolate cookies during the day and couldn't get enough of them after dinner. Of course bed time is way too early, and you just had cookies so you lay in your bed awake, wondering about the cookies down stairs. Is there any way you could get to them?

Grandma's House
An Interactive Fiction by Calien Somlak
Release 1 / Serial number 170301 / Inform 7 build 6M62 (I6/v6.33 lib 6/12N) SD

Bedroom
Completely dark, you lie on your bed. The wall across from you has an orange door. To your left is a bedside table  with a stapler on it.   There is also a broken bike horn.   Some records lie in the corner next to the window.  You can feel the despair in the room taking shape as an imaginary cookie that is out of reach.  Furthermore there's gotta be a key somewhere in the room since grandma is always scared that she'll lose her keys in which case you she can direct you to the key and you can get out. The question is where is the key...

You can see Orange door, Window, Stapler, Broken bike horn, Despair and Records here.

>attach bedside table
What do you want to attach Bedside table to?

>broken bike horn
You would achieve nothing by this.

>attach bedside table
What do you want to attach Bedside table to?

>combine broken bike horn
You can't see any such thing.

>combine broken bike horn
That's not a verb I recognise.

>combine bedside table
That's not a verb I recognise.

>attach bedside table
What do you want to attach Bedside table to?

* * *

>attach broken bike horn
What do you want to attach Broken bike horn to?

>bedside table
You would achieve nothing by this.

>combine broken bike horn
What do you want to combine Broken bike horn to?

>bedside table
You fuse together Broken bike horn and Bedside table.
You have made Hook!

>i
You are carrying nothing.

>l
Bedroom
Completely dark, you lie on your bed. The wall arcross from you has a locked orange door, bloking your exit. To your left is a bedside table with a stapler and broken bike horn on it. Some records lie in the corner next to the window. You can feel the despair in the room taking shape as an imaginary cookie that is out of reach. Furthermore there's gotta be a key somewhere in the room since grandma is always scared that she'll lose her keys in wich case you she can direct you to the key and you can get out. The question is where is the key...

You can see Hook, Orange door, Window, Stapler, Despair and Records here.

* * *

>attach broken bike horn to bedside table
You would achieve nothing by this.

>combine broken bike horn and bedside table
You can't use multiple objects with that verb.

>combine broken bike horn
What do you want to combine Broken bike horn with?

>bedside table
You fuse together Broken bike horn and Bedside table.

>i
You are carrying:
  Hook

>x hook
Now you've made a hook that you can tie things to. This will be super good for climbing out the window.

* * *

>break records
You shater the record on your bed and quickly clean up all the peices except for one large one which you keep to protect you from the bugs. You should be carefully, thankfully the walls kept you safe, but if you had done something this loud in the hallway, grandma would have waken up.

>break reords
You can't see any such thing.

>take records
Taken.

>break records
Violence isn't the answer to this one.

* * *

>break records
You shater the record on your bed and quickly clean up all the peices except for one large one which you keep to protect you from the bugs. You should be carefully, thankfully the walls kept you safe, but if you had done something this loud in the hallway, grandma would have waken up.

>l
Bedroom
Completely dark, you lie on your bed. The wall arcross from you has an orange door. To your left is a bedside table  with a stapler on it .  There is also a broken bike horn .  You can feel the despair in the room taking shape as an imaginary cookie that is out of reach.  Furthermore there's gotta be a key somewhere in the room since grandma is always scared that she'll lose her keys in wich case you she can direct you to the key and you can get out. The question is where is the key...

You can see Orange door, Window, Stapler, Broken bike horn and Despair here.

* * *

>break records
You shater the record on your bed and quickly clean up all the peices except for one large one which you keep to protect you from the bugs. You should be carefully, thankfully the walls kept you safe, but if you had done something this loud in the hallway, grandma would have waken up.

>lift sheets
You feel around under the bed with your disc shard ready, and you feel it... the Spare Key! You now have the spare key!

>take stapler
Taken.

>unlock orange with spare key
You unlock Orange door.

>w
(first opening Orange door)

Hallway
There are hallway windows on the side of the Hallway opposite of your door illumanting the objects in the room.  There's a small wooden stool grandma stands on to clean the windows since their to tall for her.  There's some old medals hanging on the wall by the bedroom door. Underneath the medals there is a table with a lamp. South of here the hallway extends to grandmas door. You also see the Hallway door which leads to the stairs, leading down to the kitchen!

You can see Orange door, Wooden stool, Lamp and Medals here.

>take medals
You, scared that grabbing to many could make extra noise grab the first medal that you touch on the wall. You now have a medal.

>take wooden stool
Taken.

>s
Grandmas entrance
Still part of the hallway you see  the sillouette of a wrench lying against the wall on the groud on the corner between the end of the line of hallway windows and  grandmas door. There is also a spare bell for the broken bike horn in your room and a rubber duck on the floor. The cat likes to play with pretty loud toys.

You can see a wrench, Spare bell and Rubber duck here.

>take wrench
Taken.

>n
Hallway
There are hallway windows on the side of the Hallway opposite of your door illumanting the objects in the room.  There's some old medals hanging on the wall by the bedroom door. Underneath the medals there is a table with a lamp. South of here the hallway extends to grandmas door. You also see the Hallway door which leads to the stairs, leading down to the kitchen!

You can see Orange door and Lamp here.

>e
Bedroom
Completely dark, you lie on your bed. The wall arcross from you has an orange door. To your left is a bedside table   There is also a broken bike horn.   You can feel the despair in the room taking shape as an imaginary cookie that is out of reach. 

You can see Orange door, Window, Broken bike horn and Despair here.

>crank open window with wrench
You unlock Window.

>combine bedside table with broken bike horn
You fuse together Bedside table and Broken bike horn.
You have made Hook!

>combine bedside table with broken bike horn
You can't see any such thing.

>combine bedside table
You can't see any such thing.

>broken bike horn
That's not a verb I recognise.

>undo
Bedroom
[Previous turn undone.]

>undo
Bedroom
[Previous turn undone.]

>combine broken bike horn and bedside table
I didn't understand that sentence.

>combine broken bike horn
I didn't understand that sentence.

>combine bedside table
You can't see any such thing.

>undo
Bedroom
[Previous turn undone.]

* * *

>combine bedside table
What do you want to combine Bedside table to?

>broken bike horn
You fuse together Bedside table and Broken bike horn.
You have made Hook!

* * *

>combine bedside table and broken bike horn
You can't use multiple objects with that verb.

>combine bedside table
What do you want to combine Bedside table with?

>broken bike horn
You fuse together Bedside table and Broken bike horn.
You have made Hook!

* * *

>combine broken bike horn
What do you want to combine Broken bike horn with?

>attach broken bike horn
What do you want to attach Broken bike horn to?

* * *

>combine broken bike horn
What do you want to combine Broken bike horn with?

>table
You fuse together Broken bike horn and Bedside table.
You have made Hook!

>take spare
Taken.

>take sheets
Cough... cough... These sheets our even dustier than I thought!

>combine hook
What do you want to combine Hook with?

>sheets
The only problem is you can't combine something as big as a bed sheet to this make shift hook, you have to combine something else to the hook in order to attach your sheets.

* * *

>d
You gotta open the window before you can get down there! I know the crank is tight, but can't you find a wrench or something?

>attach broken bike horn
What do you want to attach Broken bike horn to?

* * *

>bedside table
You would achieve nothing by this.

>bedside tabel
That's not a verb I recognise.

>attach bedside table
What do you want to attach Bedside table to?

* * *

>lift sheets
I would have to feel around for a key, and I'm too scared to put my hand underneath this dark bed without something to kill any bugs that might jump out.

>take broken disk
Taken.

>lift sheets
You feel around under the bed with your disc shard ready, and you feel it... the Spare Key! You now have Spare!

* * *

>open glass
You open Window.

>open window
That's already open.

>e
Landing Zone
You can see Window here.

* * *

>open windo
You can't see any such thing.

>open window
You open Window.

>d
Landing Zone
You can see Window here.

* * *

>open window
You open Window.

>down
You can't go that way.

>e
Landing Zone
You can see Window here.

>up
Bedroom
Completely dark, you lie on your bed. The wall arcross from you has a locked orange door, bloking your exit. To your left is a bedside table with a stapler and broken bike horn on it. Some records lie in the corner next to the window. You can feel the despair in the room taking shape as an imaginary cookie that is out of reach. Furthermore there's gotta be a key somewhere in the room since grandma is always scared that she'll lose her keys in wich case you she can direct you to the key and you can get out. The question is where is the key...

You can see Window, Orange door, Stapler, Broken bike horn, Despair and Records here.

>d
You can't go that way.

>down
You can't go that way.

* * *

>open window
You open Window.

>e
Landing Zone
You can see Window here.

>n
Light Zone

>n
Front Porch
You can see Outside door here.

>n
You can't go that way.

>w
You can't go that way.

>e
You can't go that way.

>open outside door
You must name something more substantial.

>open outside
You must name something more substantial.

>s
Light Zone

>s
Landing Zone
You can see Window here.

>e
Woods

>w
Landing Zone
You can see Window here.

>n
Light Zone

>n
Front Porch

* * *

>n
Front Porch
You can see Outside door here.

>open outside door
You open Outside door.

>w
Kitchen
You can see Outside door here.

* * *

>e
Landing Zone
You can see Window here.

>w
Bedroom
Completely dark, you lie on your bed. The wall arcross from you has a locked orange door, bloking your exit. To your left is a bedside table with a stapler and broken bike horn on it. Some records lie in the corner next to the window. You can feel the despair in the room taking shape as an imaginary cookie that is out of reach. Furthermore there's gotta be a key somewhere in the room since grandma is always scared that she'll lose her keys in wich case you she can direct you to the key and you can get out. The question is where is the key...

You can see Window, Orange door, Stapler, Broken bike horn, Despair and Records here.

>e
Landing Zone
You can see Window here.

>n
You can't go that way.

>e
You can't go that way.

* * *

>take all
There are none at all available!

>take broken disc
You can't see any such thing.

>take broken disk
Taken.

>take spare
Taken.

>take break
You can't see any such thing.

* * *

>take broken disk
Taken.

>take sheets
You feel around under the bed with your disc shard ready, and you feel it... the Spare Key! You now have Spare!

* * *

>take imaginary cookie
Are you going delusional, the cookies are downstairs, you can't eat dreams!

>x imaginary cookie
I can just imagine breaking off a nice piece with lots of chocolate chunks... theres probably something else that can break like a cookie in this room...

>take records
Taken.

* * *

>break records
Violence isn't the answer to this one.

>break records
Violence isn't the answer to this one.

* * *

>take records
Taken.

* * *

>break records
Violence isn't the answer to this one.

>break something
You can't see any such thing.

>break bed
Violence isn't the answer to this one.

>break records
Violence isn't the answer to this one.

* * *

>take records
Taken.

>drop records
Dropped.

>take records
Taken.

>break records
You shater the record on your bed and quickly clean up all the peices except for one large one which you keep to protect you from the bugs. You should be carefully, thankfully the walls kept you safe, but if you had done something this loud in the hallway, grandma would have waken up.

>undo
Bedroom
[Previous turn undone.]

>x bed
It's a stiff bed with long sheets hanging down to the floor

>x sheets
These long sheets make it easy to hide something, of course to find anything you'd have to lift the sheets...

>undo
Bedroom
[Previous turn undone.]

>take sheets
While the long sheets sure look like they could be hidding something useful I am not willing to reveal any bugs or monsters under my bed without some sort of Sharp object like broken glass.

>x sheets
These long sheets make it easy to hide something, of course to find anything you'd have to lift the sheets...

>lift sheets
While the long sheets sure look like they could be hidding something useful I am not willing to reveal any bugs or monsters under my bed without some sort of Sharp object like broken glass.

>break records
You shater the record on your bed and quickly clean up all the peices except for one large one which you keep to protect you from the bugs. You should be carefully, thankfully the walls kept you safe, but if you had done something this loud in the hallway, grandma would have waken up.

* * *

>lift sheets
You feel around under the bed with your disc shard ready, and you feel it... the Spare Key! You now have the spare key!

>unlock orange
What do you want to unlock Orange door with?

>key
You unlock Orange door.

>w
(first opening Orange door)

Hallway
There are hallway windows on the side of the Hallway opposite of your door illumanting the objects in the room.  There's a small wooden stool grandma stands on to clean the windows since they're to tall for her.  There's some old medals hanging on the wall by the bedroom door. Underneath the medals there is a table with a lamp. South of here the hallway extends to grandmas door. You also see the Hallway door which leads to the stairs, leading down to the kitchen!

You can see Orange door, Wooden stool, Lamp and Medals here.

>x windows
Tall windows. They're never opened and are really dusty.

>take medals
You, scared that grabbing to many could make extra noise grab the first medal that you touch on the wall. You now have a medal.

>take stool
Taken.

>s
Grandmas entrance
Still part of the hallway you see  the sillouette of a wrench lying against the wall on the ground on the corner between the end of the line of hallway windows and  grandmas door. There is also a spare bell for the broken bike horn in your room and a rubber duck on the floor. The cat likes to play with pretty loud toys.

You can see a wrench, Spare bell and Rubber duck here.

>take wrench
Taken.

* * *

>n
Hallway
There are hallway windows on the side of the Hallway opposite of your door illumanting the objects in the room.  There's some old medals hanging on the wall by the bedroom door. Underneath the medals there is a table with a lamp. South of here the hallway extends to grandmas door. You also see the Hallway door which leads to the stairs, leading down to the kitchen!

You can see Orange door and Lamp here.

>e
Bedroom
Completely dark, you lie on your bed. The wall arcross from you has an orange door. To your left is a bedside table  with a stapler on it.   There is also a broken bike horn.   You can feel the despair in the room taking shape as an imaginary cookie that is out of reach. 

You can see Orange door, Window, Stapler, Broken bike horn and Despair here.

>x broken bike horn
The ringer is broken, however it seems like it could still be attached to any poles about as thick as the bedside table's legs with the comand combine.

>x stapler
Seems like it could be good at hanging things up.

>take stapler
Taken.

>i
You are carrying:
  Stapler
  a wrench
  Wooden stool
  Medal
  spare key
  Broken disk

>x window
Closed with a crancking handle, but it's stuck, you probably need a wrench in order to crank it open.

>crank open window
What do you want to crank open Window with?

>wrench
You unlock Window.

>d
You gotta open the window before you can get down there!

>open window
You open Window.

>d
You're gona kill yourself kid! Haven't you seen the movies, at least make a homemade rope out of the sheets with the combine command, and then slide down on that.

* * *

>take sheets
While the long sheets sure look like they could be hidding something useful I am not willing to reveal any bugs or monsters under my bed without some sort of weapon.

I beg your pardon?

* * *

>x sheets
These long sheets make it easy to hide something, of course to find anything you'd have to lift the sheets...

* * *

>take sheets
While the long sheets sure look like they could be hidding something useful I am not willing to reveal any bugs or monsters under my bed without some sort of weapon.

>lift sheets
Long sheets rap around the bed and droop to the floor. While this seems like a place where something useful is hidden, I'm to scared of finding un-useful bugs under my bed without a weapon.

>x sheets
These long sheets make it easy to hide something, of course to find anything you'd have to lift the sheets...

>lift sheets
Long sheets rap around the bed and droop to the floor. While this seems like a place where something useful is hidden, I'm to scared of finding un-useful bugs under my bed without a weapon.

* * *

>take sheets
While the long sheets sure look like they could be hidding something useful I am not willing to reveal any bugs or monsters under my bed without some sort of weapon.

>take broken disk
Taken.

>take sheets
You feel around under the bed with your disc shard ready, and you feel it... the Spare Key! You now have the spare key!
Cough... cough... These sheets our even dustier than I thought!

>take sheets
You feel around under the bed with your disc shard ready, and you feel it... the Spare Key! You now have the spare key!
Cough... cough... These sheets our even dustier than I thought!

* * *

>take sheets
While the long sheets sure look like they could be hidding something useful I am not willing to reveal any bugs or monsters under my bed without some sort of weapon.

>take records
Taken.

* * *

>take spar
You can't see any such thing.

>take spare
Taken.

>unlock orange
(with spare key)
You unlock Orange door.

>open orange
You open Orange door.

>w
Hallway
There are hallway windows on the side of the Hallway opposite of your door illumanting the objects in the room. There's a small wooden stool grandma stands on to clean the windows since their to tall for her. There's some old medals hanging on the wall my the bedroom door. Underneath the medals there is a table with a lamp. South of here the hallway extends to grandmas door. You also see the Hallway door to the stairs.

You can see Orange door and Wooden stool here.

>stand on wooden stool
That's not something you can stand on.

>stand stool
I only understood you as far as wanting to stand.

>stand wooden stool
I only understood you as far as wanting to stand.

* * *

>take spare
Taken.

>attach bedside table
(to spare key)
You would achieve nothing by this.

>attach bedside table
(to spare key)
You would achieve nothing by this.

>attach broken bike horn
(to spare key)
You would achieve nothing by this.

>take stapler
Taken.

>attach broken bike horn to bedside table
You would achieve nothing by this.

>take records
Taken.

* * *

>break records
You shater the record on your bed and quickly clean up all the peices except for one large one which you keep to protect you from the bugs. You should be carefully, thankfully the walls kept you safe, but if you had done something this loud in the hallway, grandma would have waken up.

>take sheets
Cough... cough... These sheets our even dustier than I thought!

>drop sheets
Dropped.

>drop spare
Dropped.

>take sheets
You feel around under the bed with your disc shard ready, and you feel it... the Spare Key! You now have the spare key!

* * *

>take spare
Taken.

>drop spare
Dropped.

* * *

>take spare
Taken.

>i
You are carrying:
  spare key

>x door
You can't see any such thing.

>x orange door
I don't really like orange, also the door is old and faded.

>open orange door
It seems to be locked.

>unlock orange door
(with spare key)
You unlock Orange door.

>go through door
You can't see any such thing.

>go through orange door
(first opening Orange door)

Hallway
There are hallway windows on the side of the Hallway opposite of your door illumanting the objects in the room. There's a small wooden stool grandma stands on to clean the windows since their to tall for her. There's some old medals hanging on the wall by the bedroom door. Underneath the medals there is a table with a lamp. South of here the hallway extends to grandmas door. You also see the Hallway door which leads to the stairs, leading down to the kitchen!

You can see Orange door, Wooden stool, Lamp and Medals here.

>s
Grandmas entrance
Still part of the hallway you see the sillouette of a wrench lying against the wall on the groud on the corner between the end of the line of hallway windows and grandmas door. There is also a spare bell for the broken bike horn in your room and a rubber duck on the floor. The cat likes to play with pretty loud toys.

You can see a wrench, Spare bell and Rubber duck here.

>n
Hallway
There are hallway windows on the side of the Hallway opposite of your door illumanting the objects in the room. There's a small wooden stool grandma stands on to clean the windows since their to tall for her. There's some old medals hanging on the wall by the bedroom door. Underneath the medals there is a table with a lamp. South of here the hallway extends to grandmas door. You also see the Hallway door which leads to the stairs, leading down to the kitchen!

You can see Orange door, Wooden stool, Lamp and Medals here.

>e
Bedroom
Completely dark, you lie on your bed. The wall arcross from you has an orange door. To your left is a bedside table  with a stapler on it.   There is also a broken bike horn.   Some records lie in the corner next to the window.  You can feel the despair in the room taking shape as an imaginary cookie that is out of reach. 

You can see Orange door, Window, Stapler, Broken bike horn, Despair and Records here.

>x window
Closed with a crancking handle, but it's stuck, you probably need a wrench in order to crank it open.

>x stapler
Seems like it could be good at hanging things up.

* * *

>take stapler
Taken.

>take broken bike horn
Taken.

>w
Hallway
There are hallway windows on the side of the Hallway opposite of your door illumanting the objects in the room. There's a small wooden stool grandma stands on to clean the windows since their to tall for her. There's some old medals hanging on the wall by the bedroom door. Underneath the medals there is a table with a lamp. South of here the hallway extends to grandmas door. You also see the Hallway door which leads to the stairs, leading down to the kitchen!

You can see Orange door, Wooden stool, Lamp and Medals here.

>x wooden stool
Small wooden stool. It can fold in on itself so you can carry it around. Pretty nice!

>take wooden stool
Taken.

>drop stool
Dropped.

>take stool
Taken.

>x lamp
Heavy metal lamp with a switch on the top. It's a really bright lamp, the light will probably leak through to grandma's room if you try and turn it on, so don't.

Lamp is currently switched off.

>x medals
A bunch of old medals. The long neck straps seem good for tying down things.

>take medals
You, scared that grabbing to many could make extra noise grab the first medal that you touch on the wall. You now have a medal.

>x table
Nice old marble table, nothing much.

>s
Grandmas entrance
Still part of the hallway you see the sillouette of a wrench lying against the wall on the groud on the corner between the end of the line of hallway windows and grandmas door. There is also a spare bell for the broken bike horn in your room and a rubber duck on the floor. The cat likes to play with pretty loud toys.

You can see a wrench, Spare bell and Rubber duck here.

>x wrench
This wrench seems really good at cranking things open.

>take wrench
Taken.

>x spare bell
I heard the cat playing with it earlier. It was prettly loud so I wouldn't go near it if I were you.

>x rubber duck
I heard the cat playing with it earlier. It was prettly loud so I wouldn't go near it if I were you.

>x hallway windows
You can't see any such thing.

>x grandmas door
You can't see any such thing.

>n
Hallway
There are hallway windows on the side of the Hallway opposite of your door illumanting the objects in the room. There's a small wooden stool grandma stands on to clean the windows since their to tall for her. There's some old medals hanging on the wall by the bedroom door. Underneath the medals there is a table with a lamp. South of here the hallway extends to grandmas door. You also see the Hallway door which leads to the stairs, leading down to the kitchen!

You can see Orange door and Lamp here.

>e
Bedroom
Completely dark, you lie on your bed. The wall arcross from you has an orange door. To your left is a bedside table    Some records lie in the corner next to the window.  You can feel the despair in the room taking shape as an imaginary cookie that is out of reach. 

You can see Orange door, Window, Despair and Records here.

>crank window open
That's not a verb I recognise.

>open window
It seems to be locked.

>unlcok window
That's not a verb I recognise.

>unlock window
What do you want to unlock Window with?

>wrench
You unlock Window.

>down
You gotta open the window before you can get down there! I know the crank is tight, but can't you find a wrench or something?

>open window
You open Window.

>down
You're gona kill yourself kid! Haven't you seen the movies, at least attach the rope to something and slide down on that.

>i
You are carrying:
  a wrench
  Medal
  Wooden stool
  Broken bike horn
  Stapler
  spare key

>x broken bike horn
The ringer is broken, however it seems like it could still be attached to any poles about as thick as the bedside table's legs with the comand combine.

>combine broken bike horn with beside table
I didn't understand that sentence.

>combine broken bike horn
What do you want to combine Broken bike horn to?

>besdie table
You can't see any such thing.

>combine broken bike horn to bedside table
You fuse together Broken bike horn and Bedside table.
You have made Hook!

>down
You're gona kill yourself kid! Haven't you seen the movies, at least attach the rope to something and slide down on that.

>combine medal to hook
You fuse together Medal and Hook.
You have made Hanger!

>x hanger
Great now you have a big enough loop to attach all your sheets to!

>take sheets
Cough... cough... These sheets our even dustier than I thought!

>combine sheets to hanger
You fuse together Sheets and Hanger.
You have made Homemade rope!

>down
You swing down the outside of the house, feeling the cool night breeze softly landing on the grass outside.

Landing Zone
You are now outside at, there is a cool breeze and moonlight illuminating the grass.

You can see Window here.

* * *

>take spare
Taken.

>open orange
It seems to be locked.

>unlock orange
(with spare key)
You unlock Orange door.

* * *

>w
Hallway
There are hallway windows on the side of the Hallway opposite of your door illumanting the objects in the room. There's a small wooden stool grandma stands on to clean the windows since their to tall for her. There's some old medals hanging on the wall my the bedroom door. Underneath the medals there is a table with a lamp. South of here the hallway extends to grandmas door. You also see the Hallway door to the stairs.

You can see Orange door and Wooden stool here.

>stand stool
I only understood you as far as wanting to stand.

>stand on wooden stool
That's not something you can stand on.

>stand on stool
That's not something you can stand on.

>get in stool
That's not something you can enter.

>enter stool
That's not something you can enter.

>get on stool
That's not something you can enter.

>get on stool
That's not something you can enter.

>take stool
Taken.

>drop stool
Dropped.

* * *

>unlock orange
(with spare key)
You unlock Orange door.

>w
(first opening Orange door)

Hallway
There are hallway windows on the side of the Hallway opposite of your door illumanting the objects in the room.  There's a small wooden stool grandma stands on to clean the windows since their to tall for her.  There's some old medals hanging on the wall by the bedroom door. Underneath the medals there is a table with a lamp. South of here the hallway extends to grandmas door. You also see the Hallway door which leads to the stairs, leading down to the kitchen!

You can see Orange door, Wooden stool, Lamp and Medals here.

>take wooden stool
Taken.

>take medals
You, scared that grabbing to many could make extra noise grab the first medal that you touch on the wall. You now have a medal.

>s
Grandmas entrance
Still part of the hallway you see  the sillouette of a wrench lying against the wall on the groud on the corner between the end of the line of hallway windows and  grandmas door. There is also a spare bell for the broken bike horn in your room and a rubber duck on the floor. The cat likes to play with pretty loud toys.

You can see a wrench, Spare bell and Rubber duck here.

* * *

>n
Hallway
There are hallway windows on the side of the Hallway opposite of your door illumanting the objects in the room.  There's some old medals hanging on the wall by the bedroom door. Underneath the medals there is a table with a lamp. South of here the hallway extends to grandmas door. You also see the Hallway door which leads to the stairs, leading down to the kitchen!

You can see Orange door and Lamp here.

>e
Bedroom
Completely dark, you lie on your bed. The wall arcross from you has an orange door. To your left is a bedside table  with a stapler on it.   There is also a broken bike horn.   Some records lie in the corner next to the window.  You can feel the despair in the room taking shape as an imaginary cookie that is out of reach. 

You can see Orange door, Window, Stapler, Broken bike horn, Despair and Records here.

>take stapler
Taken.

>combine broken bike horn with bedside table
I didn't understand that sentence.

>combine broken bike horn
What do you want to combine Broken bike horn to?

* * *

>bedside table
You fuse together Broken bike horn and Bedside table.
You have made Hook!

>combine medal
What do you want to combine Medal to?

>hook
You fuse together Medal and Hook.
You have made Hanger!

>take sheets
Cough... cough... These sheets our even dustier than I thought!

>combine hanger
What do you want to combine Hanger to?

>sheets
You fuse together Hanger and Sheets.
You have made Homemade rope!

>unlock window
What do you want to unlock Window with?

* * *

>open window
You open Window.

>d
You swing down the outside of the house, feeling the cool night breeze softly landing on the grass outside.

Landing Zone
You are now outside at, there is a cool breeze and moonlight illuminating the grass. To the east you see the woods and north brings you towards the door, which leads to the kitchen... and the cookies!!

You can see Window here.

>e
Woods
Its just grass. Oh look it's the cat, he's playing with a pile of leaves. I love the cat. Whats that? Did I just hear the cat speak to me??

You can see Cat and Leaves here.

>talk to cat
"Is that you?" you say hesitantly. 

"Yup it's really me, though I have to point out you are a very imaginative child." the cat replies casually.

>g
 "Umm.... is there anything taht you have to say, you know, as a cat?" 

 "I mean I'm a cat so I'm good at sneaking around, I could give you some pointers" the cat replies in a friendly manner."

>g
"How do I get to the door of the house" you ask the cat. 

 "Okay I can see your persistance, so I'll give you a hint. Take these leave that I've gathered so nicely for you, and simply staple___" the cat says and then dashes into the bushes!

>take leaves
Taken.

>w
Landing Zone
You are now outside at, there is a cool breeze and moonlight illuminating the grass. To the east you see the woods and north brings you towards the door, which leads to the kitchen... and the cookies!!

You can see Window here.

>n
Light Zone
Between landing zone and the door to the kitchen.  Wait! Theres a motion activated light north of here between here and the front porch with the door on it. If you go that way the light with give you away!

>stapple leaves
That's not a verb I recognise.

>staple
What do you want to staple?

>leaves
You staple the leaves to the wall bloking the light from reaching upstairs. Now safely go to the porch up north!

>n
The light turns on, but thankfully your leaves dim the light.

Front Porch
You can see Outside door here.

>s
Light Zone
Between landing zone and the door to the kitchen. 

You can see Leaves here.

>take leaves
Taken.

>n
The light turns on, and grandma's six sence wakes her up... Looks like you'll never even see cookies at grandma's house again.

    *** The End ***

Would you like to RESTART, RESTORE a saved game, QUIT or UNDO the last command?

* * *

>open orange
It seems to be locked.

>unlock orange with spare
You unlock Orange door.

>open door
You can't see any such thing.

>open orange door
You open Orange door.

>w
Hallway
There are windows on the side of the Hallway opposite of your door illumanting the objects in the room. There's a small wooden stool grandma stands on to clean the windows since their to tall for her. There's some old medals hanging on the wall my the bedroom door. Underneath the medals there is a table with a lamp. South of here the hallway extends to grandmas door. You also see the Hallway door to the stairs.

You can see Orange door here.

>n
You can't go that way.

>s
Grandmas entrence

>take wrench
You can't see any such thing.

* * *

>take sheets
Cough... cough... These sheets our even dustier than I thought!

>take broken disk
Taken.

>take sheets
Cough... cough... These sheets our even dustier than I thought!

* * *

>open orange
You open Orange door.

>turn on lamp
You can't see any such thing.

>w
Hallway
There are hallway windows on the side of the Hallway opposite of your door illumanting the objects in the room. There's a small wooden stool grandma stands on to clean the windows since their to tall for her. There's some old medals hanging on the wall by the bedroom door. Underneath the medals there is a table with a lamp. South of here the hallway extends to grandmas door. You also see the Hallway door to the stairs.

You can see Orange door, Wooden stool and Lamp here.

>turn on lamp
It isn't something you can switch.

>turn on lamp
It isn't something you can switch.

* * *

>open orange
You open Orange door.

>w
Hallway
There are hallway windows on the side of the Hallway opposite of your door illumanting the objects in the room.  There's a small wooden stool grandma stands on to clean the windows since their to tall for her.  There's some old medals hanging on the wall by the bedroom door. Underneath the medals there is a table with a lamp. South of here the hallway extends to grandmas door. You also see the Hallway door which leads to the stairs, leading down to the kitchen!

You can see Orange door, Wooden stool, Lamp and Medals here.

>s
Grandmas entrance
Still part of the hallway you see  the sillouette of a wrench lying against the wall on the groud on the corner between the end of the line of hallway windows and  grandmas door. There is also a spare bell for the broken bike horn in your room and a rubber duck on the floor. The cat likes to play with pretty loud toys.

You can see a wrench, Spare bell and Rubber duck here.

>n
Hallway
There are hallway windows on the side of the Hallway opposite of your door illumanting the objects in the room. There's a small wooden stool grandma stands on to clean the windows since their to tall for her. There's some old medals hanging on the wall my the bedroom door. Underneath the medals there is a table with a lamp. South of here the hallway extends to grandmas door. You also see the Hallway door to the stairs.

You can see Orange door and Wooden stool here.

>stand on wooden stool
That's not something you can stand on.

* * *

>take wrench
Taken.

>n
Hallway
There are hallway windows on the side of the Hallway opposite of your door illumanting the objects in the room.  There's a small wooden stool grandma stands on to clean the windows since their to tall for her.  There's some old medals hanging on the wall by the bedroom door. Underneath the medals there is a table with a lamp. South of here the hallway extends to grandmas door. You also see the Hallway door which leads to the stairs, leading down to the kitchen!

You can see Orange door, Wooden stool, Lamp and Medals here.

>e
Bedroom
Completely dark, you lie on your bed. The wall arcross from you has an orange door. To your left is a bedside table  with a stapler on it.   There is also a broken bike horn.   Some records lie in the corner next to the window.  You can feel the despair in the room taking shape as an imaginary cookie that is out of reach. 

You can see Orange door, Window, Stapler, Broken bike horn, Despair and Records here.

>crang window
That's not a verb I recognise.

>crank window
What do you want to crank Window with?

>crank open window
What do you want to crank open Window with?

>crank open window with wrench
You unlock Window.

>crank window with wrench
That's unlocked at the moment.

* * *

>e
Bedroom
Completely dark, you lie on your bed. The wall arcross from you has an orange door. To your left is a bedside table  with a stapler on it.   There is also a broken bike horn.   Some records lie in the corner next to the window.  You can feel the despair in the room taking shape as an imaginary cookie that is out of reach. 

You can see Orange door, Window, Stapler, Broken bike horn, Despair and Records here.

>unlock window with wrench
You unlock Window.

>d
(first opening Window)

Landing Zone
You can see Window here.

* * *

>n
Hallway
There are hallway windows on the side of the Hallway opposite of your door illumanting the objects in the room.  There's a small wooden stool grandma stands on to clean the windows since their to tall for her.  There's some old medals hanging on the wall by the bedroom door. Underneath the medals there is a table with a lamp. South of here the hallway extends to grandmas door. You also see the Hallway door which leads to the stairs, leading down to the kitchen!

You can see Orange door, Wooden stool, Lamp and Medals here.

>take medals
You, scared that grabbing to many could make extra noise grab the first medal that you touch on the wall. You now have a medal.

* * *

>take stool
Taken.

>e
Bedroom
Completely dark, you lie on your bed. The wall arcross from you has a locked orange door, bloking your exit. To your left is a bedside table with a stapler and broken bike horn on it. Some records lie in the corner next to the window. You can feel the despair in the room taking shape as an imaginary cookie that is out of reach. Furthermore there's gotta be a key somewhere in the room since grandma is always scared that she'll lose her keys in wich case you she can direct you to the key and you can get out. The question is where is the key...

You can see Orange door, Window, Stapler, Broken bike horn, Despair and Records here.

>take stappler
You can't see any such thing.

>take stapler
Taken.

>combine broken bike horn
What do you want to combine Broken bike horn to?

* * *

>bedside table
You fuse together Broken bike horn and Bedside table.
You have made Hook!

>combine hook
What do you want to combine Hook to?

>medal
You fuse together Hook and Medal.
You have made Hanger!

>take sheets
Cough... cough... These sheets our even dustier than I thought!

* * *

>sheets
You fuse together Hanger and Sheets.
You have made Homemade rope!

>d
you go down
Landing Zone
You can see Window here.

* * *

>take wrench
Taken.

>take bell
you reach for the bell and in the process of picking it up it rings alerting grandma. Your in big trouble for sneaking around a night!

    *** The End ***

Would you like to RESTART, RESTORE a saved game, QUIT or UNDO the last command?

>restore
Restore failed.

Would you like to RESTART, RESTORE a saved game, QUIT or UNDO the last command?

* * *

>s
Grandmas entrance
Still part of the hallway you see  the sillouette of a wrench lying against the wall on the groud on the corner between the end of the line of hallway windows and  grandmas door. There is also a spare bell for the broken bike horn in your room and a rubber duck on the floor. The cat likes to play with pretty loud toys.

You can see a wrench, Spare bell and Rubber duck here.

>turn on lamp
You can't see any such thing.

>n
Hallway
There are hallway windows on the side of the Hallway opposite of your door illumanting the objects in the room. There's a small wooden stool grandma stands on to clean the windows since their to tall for her. There's some old medals hanging on the wall by the bedroom door. Underneath the medals there is a table with a lamp. South of here the hallway extends to grandmas door. You also see the Hallway door which leads to the stairs, leading down to the kitchen!

You can see Orange door, Wooden stool, Lamp and Medals here.

>turn on lamp
You turn on the light, ignoring my advice like an idiot and grandma wakes up. Maybe you'll trust me more next time.

    *** The End ***

Would you like to RESTART, RESTORE a saved game, QUIT or UNDO the last command?

* * *

>w
Hallway
There are hallway windows on the side of the Hallway opposite of your door illumanting the objects in the room.  There's a small wooden stool grandma stands on to clean the windows since their to tall for her.  There's some old medals hanging on the wall by the bedroom door. Underneath the medals there is a table with a lamp. South of here the hallway extends to grandmas door. You also see the Hallway door which leads to the stairs, leading down to the kitchen!

You can see Orange door, Wooden stool, Lamp and Medals here.

>switch lamp
It isn't something you can switch.

>turn on lamp
It isn't something you can switch.

* * *

>w
Hallway
There are hallway windows on the side of the Hallway opposite of your door illumanting the objects in the room.  There's a small wooden stool grandma stands on to clean the windows since their to tall for her.  There's some old medals hanging on the wall by the bedroom door. Underneath the medals there is a table with a lamp. South of here the hallway extends to grandmas door. You also see the Hallway door which leads to the stairs, leading down to the kitchen!

You can see Orange door, Wooden stool, Lamp and Medals here.

>take lamp
That's fixed in place.

>switch lamp
It isn't something you can switch.

* * *

>w
Hallway
There are hallway windows on the side of the Hallway opposite of your door illumanting the objects in the room.  There's a small wooden stool grandma stands on to clean the windows since their to tall for her.  There's some old medals hanging on the wall by the bedroom door. Underneath the medals there is a table with a lamp. South of here the hallway extends to grandmas door. You also see the Hallway door which leads to the stairs, leading down to the kitchen!

You can see Orange door, Wooden stool, Lamp and Medals here.

>take medal
Taken.

>e
Bedroom
Completely dark, you lie on your bed. The wall arcross from you has a locked orange door, bloking your exit. To your left is a bedside table with a stapler and broken bike horn on it. Some records lie in the corner next to the window. You can feel the despair in the room taking shape as an imaginary cookie that is out of reach. Furthermore there's gotta be a key somewhere in the room since grandma is always scared that she'll lose her keys in wich case you she can direct you to the key and you can get out. The question is where is the key...

You can see Orange door, Window, Stapler, Broken bike horn, Despair and Records here.

>take sheets
Cough... cough... These sheets our even dustier than I thought!

>combine hook
You can't see any such thing.

>attach bedside table
What do you want to attach Bedside table to?

* * *

>broken bike horn
You would achieve nothing by this.

>combine table
What do you want to combine Bedside table to?

>broken bike horn
You fuse together Bedside table and Broken bike horn.
You have made Hook!

>combine hook
What do you want to combine Hook to?

>sheets
You can't combine Hook and Sheets into anything useful.
Try another combination of things.

* * *

>w
Hallway
There are hallway windows on the side of the Hallway opposite of your door illumanting the objects in the room.  There's a small wooden stool grandma stands on to clean the windows since their to tall for her.  There's some old medals hanging on the wall by the bedroom door. Underneath the medals there is a table with a lamp. South of here the hallway extends to grandmas door. You also see the Hallway door which leads to the stairs, leading down to the kitchen!

You can see Orange door, Wooden stool, Lamp and Medals here.

>take medals
You, scared that grabbing to many could make extra noise grab the first medal that you touch on the wall. You now have a medal.

>i
You are carrying:
  Medal
  spare key

* * *

>w
Hallway
There are hallway windows on the side of the Hallway opposite of your door illumanting the objects in the room.  There's a small wooden stool grandma stands on to clean the windows since their to tall for her.  There's some old medals hanging on the wall by the bedroom door. Underneath the medals there is a table with a lamp. South of here the hallway extends to grandmas door. You also see the Hallway door which leads to the stairs, leading down to the kitchen!

You can see Orange door, Wooden stool, Lamp and Medals here.

>turn on lamb
You can't see any such thing.

>turn on lamp
It isn't something you can switch.

* * *

>w
Hallway
There are hallway windows on the side of the Hallway opposite of your door illumanting the objects in the room.  There's a small wooden stool grandma stands on to clean the windows since their to tall for her.  There's some old medals hanging on the wall by the bedroom door. Underneath the medals there is a table with a lamp. South of here the hallway extends to grandmas door. You also see the Hallway door which leads to the stairs, leading down to the kitchen!

You can see Orange door, Wooden stool, Lamp and Medals here.

>turn on lamp
It isn't something you can switch.

>switch lamp
It isn't something you can switch.

* * *

>w
(first opening Orange door)

Hallway
There are hallway windows on the side of the Hallway opposite of your door illumanting the objects in the room.  There's a small wooden stool grandma stands on to clean the windows since their to tall for her.  There's some old medals hanging on the wall by the bedroom door. Underneath the medals there is a table with a lamp. South of here the hallway extends to grandmas door. You also see the Hallway door which leads to the stairs, leading down to the kitchen!

You can see Orange door, Wooden stool, Lamp and Medals here.

>s
Grandmas entrance
Still part of the hallway you see  the sillouette of a wrench lying against the wall on the groud on the corner between the end of the line of hallway windows and  grandmas door. There is also a spare bell for the broken bike horn in your room and a rubber duck on the floor. The cat likes to play with pretty loud toys.

You can see a wrench, Spare bell and Rubber duck here.

* * *

>n
Hallway
There are hallway windows on the side of the Hallway opposite of your door illumanting the objects in the room.  There's a small wooden stool grandma stands on to clean the windows since their to tall for her.  There's some old medals hanging on the wall by the bedroom door. Underneath the medals there is a table with a lamp. South of here the hallway extends to grandmas door. You also see the Hallway door which leads to the stairs, leading down to the kitchen!

You can see Orange door, Wooden stool, Lamp and Medals here.

>s
Grandmas entrance
Still part of the hallway you see  grandmas door. There is also a spare bell for the broken bike horn in your room and a rubber duck on the floor. The cat likes to play with pretty loud toys.

You can see Spare bell and Rubber duck here.

>n
Hallway
There are hallway windows on the side of the Hallway opposite of your door illumanting the objects in the room.  There's a small wooden stool grandma stands on to clean the windows since their to tall for her.  There's some old medals hanging on the wall by the bedroom door. Underneath the medals there is a table with a lamp. South of here the hallway extends to grandmas door. You also see the Hallway door which leads to the stairs, leading down to the kitchen!

You can see Orange door, Wooden stool, Lamp and Medals here.

* * *

>e
Bedroom
Completely dark, you lie on your bed. The wall arcross from you has an orange door. To your left is a bedside table  with a stapler on it.   There is also a broken bike horn.   Some records lie in the corner next to the window.  You can feel the despair in the room taking shape as an imaginary cookie that is out of reach. 

You can see Orange door, Window, Stapler, Broken bike horn, Despair and Records here.

>crank open window
It seems to be locked.

>crank window
It seems to be locked.

* * *

>w
(first opening Orange door)

Hallway
There are hallway windows on the side of the Hallway opposite of your door illumanting the objects in the room.  There's a small wooden stool grandma stands on to clean the windows since their to tall for her.  There's some old medals hanging on the wall by the bedroom door. Underneath the medals there is a table with a lamp. South of here the hallway extends to grandmas door. You also see the Hallway door which leads to the stairs, leading down to the kitchen!

You can see Orange door, Wooden stool, Lamp and Medals here.

>stand on stool
You get onto Wooden stool.

>get in stool
But you're already on Wooden stool.

>take stool
You would have to get off Wooden stool first.

>get off stool
You get off Wooden stool.

Hallway
There are hallway windows on the side of the Hallway opposite of your door illumanting the objects in the room.  There's a small wooden stool grandma stands on to clean the windows since their to tall for her.  There's some old medals hanging on the wall by the bedroom door. Underneath the medals there is a table with a lamp. South of here the hallway extends to grandmas door. You also see the Hallway door which leads to the stairs, leading down to the kitchen!

You can see Orange door, Wooden stool, Lamp and Medals here.

>s
Grandmas entrance
Still part of the hallway you see  the sillouette of a wrench lying against the wall on the groud on the corner between the end of the line of hallway windows and  grandmas door. There is also a spare bell for the broken bike horn in your room and a rubber duck on the floor. The cat likes to play with pretty loud toys.

You can see a wrench, Spare bell and Rubber duck here.

>drop stool
You can't see any such thing.

>n
Hallway
There are hallway windows on the side of the Hallway opposite of your door illumanting the objects in the room.  There's a small wooden stool grandma stands on to clean the windows since their to tall for her.  There's some old medals hanging on the wall by the bedroom door. Underneath the medals there is a table with a lamp. South of here the hallway extends to grandmas door. You also see the Hallway door which leads to the stairs, leading down to the kitchen!

You can see Orange door, Wooden stool, Lamp and Medals here.

>take stool
Taken.

>s
Grandmas entrance
Still part of the hallway you see  the sillouette of a wrench lying against the wall on the groud on the corner between the end of the line of hallway windows and  grandmas door. There is also a spare bell for the broken bike horn in your room and a rubber duck on the floor. The cat likes to play with pretty loud toys.

You can see a wrench, Spare bell and Rubber duck here.

>drop stool
You quietly place down the stool.

>take stool
Taken.

>take wrench
Taken.

>n
Hallway
There are hallway windows on the side of the Hallway opposite of your door illumanting the objects in the room.  There's some old medals hanging on the wall by the bedroom door. Underneath the medals there is a table with a lamp. South of here the hallway extends to grandmas door. You also see the Hallway door which leads to the stairs, leading down to the kitchen!

You can see Orange door, Lamp and Medals here.

>take medals
You, scared that grabbing to many could make extra noise grab the first medal that you touch on the wall. You now have a medal.

>e
Bedroom
Completely dark, you lie on your bed. The wall arcross from you has an orange door. To your left is a bedside table  with a stapler on it.   There is also a broken bike horn.   Some records lie in the corner next to the window.  You can feel the despair in the room taking shape as an imaginary cookie that is out of reach. 

You can see Orange door, Window, Stapler, Broken bike horn, Despair and Records here.

>take broken bike horn
Taken.

>take stapler
Taken.

>crank open window
What do you want to crank open Window with?

* * *

>open window
You open Window.

>combine broken bike horn
What do you want to combine Broken bike horn to?

* * *

>bedside table
You fuse together Broken bike horn and Bedside table.
You have made Hook!

>take sheets
Cough... cough... These sheets our even dustier than I thought!

>attach hook
What do you want to attach Hook to?

>sheets
You would achieve nothing by this.

>combine hook
What do you want to combine Hook to?

>sheets
The only problem is you can't attach something as big as a bed sheet to this make shift hook, you have to combine something else to the hook in order to attach your sheets.

>combine hook
What do you want to combine Hook to?

* * *

>medal
You fuse together Hook and Medal.
You have made Hanger!

>combine hanger
What do you want to combine Hanger to?

* * *

>sheets
You fuse together Hanger and Sheets.
You have made Homemade rope!

>d
You swing down the outside of the house, feeling the cool night breeze softly landing on the grass outside.

Landing Zone
You are now outside at, there is a cool breeze and moonlight illuminating the grass. To the east you see the woods and north brings you towards the door, which leads to the kitchen... and the cookies!!

You can see Window here.

>w
Bedroom
Completely dark, you lie on your bed. The wall arcross from you has an orange door. To your left is a bedside table   There is also a broken bike horn.   Some records lie in the corner next to the window.  You can feel the despair in the room taking shape as an imaginary cookie that is out of reach. 

You can see Window, Homemade rope, Orange door, Despair and Records here.

>d
You swing down the outside of the house, feeling the cool night breeze softly landing on the grass outside.

Landing Zone
You are now outside at, there is a cool breeze and moonlight illuminating the grass. To the east you see the woods and north brings you towards the door, which leads to the kitchen... and the cookies!!

You can see Window here.

>e
Woods
It's just a plain field.  Oh look it's the cat, he's playing with a pile of leaves. I love the cat. Whats that? Did I just hear the cat speak to me??

You can see Leaves here.

>talk to cat
"Is that you?" you say hesitantly. 

"Yup it's really me, though I have to point out you are a very imaginative child." the cat replies casually.

* * *

>g
"How do I get to the door of the house" you ask the cat. 

 "Okay I can see your persistance, so I'll give you a hint. Take these leave that I've gathered so nicely for you, and simply staple___" the cat says and then dashes into the bushes!

>g
 the cat left for some reason.

>take leaves
Taken.

* * *

>w
Landing Zone
You are now outside at, there is a cool breeze and moonlight illuminating the grass. To the east you see the woods and north brings you towards the door, which leads to the kitchen... and the cookies!!

You can see Window here.

>e
Woods
It's just a plain field.

>w
Landing Zone
You are now outside at, there is a cool breeze and moonlight illuminating the grass. To the east you see the woods and north brings you towards the door, which leads to the kitchen... and the cookies!!

You can see Window here.

>n
Light Zone
Between landing zone and the door to the kitchen.  Wait! Theres a motion activated light north of here between here and the front porch with the door on it. If you go that way the light with give you away!

You can see Light here.

>staple leaves
You staple the leaves to the wall bloking the light from reaching upstairs. Now safely go to the porch up north!

>take light
You carefully remove the light under the safety of the leaves...

>n
The light turns on, but thankfully your leaves dim the light.

Front Porch
Your right in front of Green door now! Lucky for you grandma doesn't lock this door. (She isn't scared of getting robbed, but is scared of you running around in the woods a night)

You can see Outside door here.

>w
(first opening Outside door)

Kitchen
You've made it!   You see the cookies on the top shelf above the sink. Now the only question is, how are you going to reach them? 

You can see Outside door here.

>drop stool
You quietly place down the stool.

>stand on stool
You get onto Wooden stool.

>take cookies
You reach up safely feel the crumbly, soft, mouth watering, delicious cookies. Nothing could have made this day better!

    *** The End ***

Would you like to RESTART, RESTORE a saved game, QUIT or UNDO the last command?

>undo
Kitchen
[Previous turn undone.]

>undo
Kitchen
[Previous turn undone.]

>undo
Front Porch
[Previous turn undone.]

>undo
Light Zone
[Previous turn undone.]

>undo
Light Zone
[Previous turn undone.]

>staple leaves
You staple the leaves to the wall bloking the light from reaching upstairs. Now safely go to the porch up north!

>n
The light turns on, but thankfully your leaves dim the light.

Front Porch
Your right in front of Green door now! Lucky for you grandma doesn't lock this door. (She isn't scared of getting robbed, but is scared of you running around in the woods a night)

You can see Outside door here.

>w
(first opening Outside door)

Kitchen
You've made it!  However it's really dark and you can't find the cookies. All you have to do is take them, but stubbling around could wake up grandma!  

You can see Outside door here.

>e
The light turns on, but thankfully your leaves dim the light.

Front Porch
Your right in front of Green door now! Lucky for you grandma doesn't lock this door. (She isn't scared of getting robbed, but is scared of you running around in the woods a night)

You can see Outside door here.

>s
Light Zone
Between landing zone and the door to the kitchen. 

You can see Leaves and Light here.

>take light
You carefully remove the light under the safety of the leaves...

* * *

>n
The light turns on, but thankfully your leaves dim the light.

Front Porch
Your right in front of Green door now! Lucky for you grandma doesn't lock this door. (She isn't scared of getting robbed, but is scared of you running around in the woods a night)

You can see Outside door here.

>w
Kitchen
You've made it!   You see the cookies on the top shelf above the sink. Now the only question is, how are you going to reach them? 

You can see Outside door here.

>eat cookies
That's plainly inedible.

* * *

>stand on stool
You get onto Wooden stool.

>take stool
Taken.

* * *

>e
Bedroom
Completely dark, you lie on your bed. The wall arcross from you has an orange door. To your left is a bedside table  with a stapler on it.   There is also a broken bike horn.   Some records lie in the corner next to the window.  You can feel the despair in the room taking shape as an imaginary cookie that is out of reach. 

You can see Orange door, Window, Stapler, Broken bike horn, Despair and Records here.

>crank open window with wrench
You unlock Window.

* * *

>combine bedside table with broken bike horn
You fuse together Bedside table and Broken bike horn.
You have made Hook!

>combine hook with medal
You fuse together Hook and Medal.
You have made Hanger!

>combine hanger with sheets
You fuse together Hanger and Sheets.
You have made Homemade rope!

>d
You gotta open the window before you can get down there!

* * *

>open window
You open Window.

>d
You swing down the outside of the house, feeling the cool night breeze softly landing on the grass outside.

Landing Zone
You are now outside at, there is a cool breeze and moonlight illuminating the grass. To the east you see the woods and the north leads towards the door, which leads to the kitchen... and the cookies!!

You can see Window here.

>w
Bedroom
Completely dark, you lie on your bed. The wall arcross from you has an orange door. To your left is a bedside table  with a stapler on it.   There is also a broken bike horn.   Some records lie in the corner next to the window.  You can feel the despair in the room taking shape as an imaginary cookie that is out of reach. 

You can see Window, Homemade rope, Orange door, Stapler, Despair and Records here.

>e
You can't go that way.

>d
You swing down the outside of the house, feeling the cool night breeze softly landing on the grass outside.

Landing Zone
You are now outside at, there is a cool breeze and moonlight illuminating the grass. To the east you see the woods and the north leads towards the door, which leads to the kitchen... and the cookies!!

You can see Window here.

>e
Woods
It's just a plain field.  Oh look it's the cat, he's playing with a pile of leaves. I love the cat. Whats that? Did I just hear the cat speak to me??

You can see Leaves here.

>take leaves
Taken.

>w
Landing Zone
You are now outside at, there is a cool breeze and moonlight illuminating the grass. To the east you see the woods and the north leads towards the door, which leads to the kitchen... and the cookies!!

You can see Window here.

>n
Light Zone
Between landing zone and the door to the kitchen.  Wait! There's a motion activated light north of here, it's between you and the door. If you go that way the light will turn on and give you away!

You can see Light here.

>staple leaves
How are you going to stapple the leaves over the light if you don't have the stapler!

>s
Landing Zone
You are now outside at, there is a cool breeze and moonlight illuminating the grass. To the east you see the woods and the north leads towards the door, which leads to the kitchen... and the cookies!!

You can see Window here.

>w
Bedroom
Completely dark, you lie on your bed. The wall arcross from you has an orange door. To your left is a bedside table  with a stapler on it.   There is also a broken bike horn.   Some records lie in the corner next to the window.  You can feel the despair in the room taking shape as an imaginary cookie that is out of reach. 

You can see Window, Homemade rope, Orange door, Stapler, Despair and Records here.

>take stapler
Taken.

>d
You swing down the outside of the house, feeling the cool night breeze softly landing on the grass outside.

Landing Zone
You are now outside at, there is a cool breeze and moonlight illuminating the grass. To the east you see the woods and the north leads towards the door, which leads to the kitchen... and the cookies!!

You can see Window here.

>n
Light Zone
Between landing zone and the door to the kitchen.  Wait! There's a motion activated light north of here, it's between you and the door. If you go that way the light will turn on and give you away!

You can see Light here.

>staple leaves
You staple the leaves to the wall bloking the light from reaching upstairs. Now safely go to the porch up north!

* * *

>take light
You carefully remove the light under the safety of the leaves...

>n
Front Porch
Your right in front of outside door now! Lucky for you grandma doesn't lock this door. (She isn't scared of getting robbed, but is scared of you running around in the woods a night)

You can see Outside door here.

>s
Light Zone
Between landing zone and the door to the kitchen. 

You can see Leaves here.

>undo
Front Porch
[Previous turn undone.]

>staple leaves
You can't see any such thing.

>take light
You carefully remove the light under the safety of the leaves...

>n
You can't go that way.

>undo
Front Porch
[Previous turn undone.]

>n
You can't go that way.

>l
Front Porch
Your right in front of outside door now! Lucky for you grandma doesn't lock this door. (She isn't scared of getting robbed, but is scared of you running around in the woods a night)

You can see Outside door here.

>w
(first opening Outside door)

Kitchen
You've made it!   You see the cookies on the top shelf above the sink. To take them however you have to be able to reach them. Now the only question is, how are you going to reach them? 

You can see Outside door here.

>drop stool
You quietly place down the stool.

* * *

>take spare
Taken.

>unlock orange with spare
You unlock Orange door.

>open orange
You open Orange door.

>w
Hallway
There are windows on the side of the Hallway opposite of your door illumanting the objects in the room. There's a small wooden stool grandma stands on to clean the windows since their to tall for her. There's some old medals hanging on the wall my the bedroom door. Underneath the medals there is a table with a lamp. South of here the hallway extends to grandmas door. You also see the Hallway door to the stairs.

You can see Orange door here.

>s
Grandmas entrance
This wrench seems really good at cranking things open.

* * *

>unlock orange with spare
You unlock Orange door.

>open orange door
You open Orange door.

* * *

>s
Grandmas entrance
This wrench seems really good at cranking things open.

>take wrench
Taken.

>take wrench
You already have that.

>n
Hallway
There are windows on the side of the Hallway opposite of your door illumanting the objects in the room. There's a small wooden stool grandma stands on to clean the windows since their to tall for her. There's some old medals hanging on the wall my the bedroom door. Underneath the medals there is a table with a lamp. South of here the hallway extends to grandmas door. You also see the Hallway door to the stairs.

You can see Orange door here.

>e
Bedroom
Completely dark, you lie on your bed. The wall arcross from you has a locked orange door, bloking your exit. To your left is a bedside table with a stapler and broken bike horn on it. Some records lie in the corner next to the window. You can feel the despair in the room taking shape as an imaginary cookie that is out of reach. Furthermore there's gotta be a key somewhere in the room since grandma is always scared that she'll lose her keys in wich case you she can direct you to the key and you can get out. The question is where is the key...

You can see Orange door, Window, Stapler, Broken bike horn, Despair and Records here.

>unlock window with wrench
That doesn't seem to be something you can unlock.

* * *

>unlock orange with spare
You unlock Orange door.

>w
(first opening Orange door)

Hallway
There are windows on the side of the Hallway opposite of your door illumanting the objects in the room. There's a small wooden stool grandma stands on to clean the windows since their to tall for her. There's some old medals hanging on the wall my the bedroom door. Underneath the medals there is a table with a lamp. South of here the hallway extends to grandmas door. You also see the Hallway door to the stairs.

You can see Orange door here.

>s
Grandmas entrance
This wrench seems really good at cranking things open.

* * *

>take spare
Taken.

>w
(first opening Orange door)
It seems to be locked.

>unlock orange
(with spare key)
You unlock Orange door.

>w
(first opening Orange door)

Hallway
There are hallway windows on the side of the Hallway opposite of your door illuminating the objects in the room.  There's a small wooden stool grandma stands on to clean the windows since they're too tall for her.  There's some old medals hanging on the wall by the bedroom door. Underneath the medals there is a table with a lamp. South of here the hallway extends to grandma's door. You also see the Hallway door which leads to the stairs, leading down to the kitchen!

You can see Orange door, Wooden stool, Lamp and Medals here.

>s
Grandmas entrance
Still part of the hallway you see  the silhouette of a wrench lying against the wall on the ground on the corner between the end of the line of hallway windows and  grandmas door. There is also a spare bell for the broken bike horn in your room and a rubber duck on the floor. The cat likes to play with pretty loud toys.

You can see a wrench, Spare bell and Rubber duck here.

>take wrench
Taken.

>n
Hallway
There are hallway windows on the side of the Hallway opposite of your door illuminating the objects in the room.  There's a small wooden stool grandma stands on to clean the windows since they're too tall for her.  There's some old medals hanging on the wall by the bedroom door. Underneath the medals there is a table with a lamp. South of here the hallway extends to grandma's door. You also see the Hallway door which leads to the stairs, leading down to the kitchen!

You can see Orange door, Wooden stool, Lamp and Medals here.

>e
Bedroom
Completely dark, you lie on your bed. The wall across from you has an orange door. To your left is a bedside table  with a stapler on it.   There is also a broken bike horn.   Some records lie in the corner next to the window.  You can feel the despair in the room taking shape as an imaginary cookie that is out of reach. 

You can see Orange door, Window, Stapler, Broken bike horn, Despair and Records here.

>crank window open
What do you want to crank Window open with?

>wrench
You unlock Window.

>w
Hallway
There are hallway windows on the side of the Hallway opposite of your door illuminating the objects in the room.  There's a small wooden stool grandma stands on to clean the windows since they're too tall for her.  There's some old medals hanging on the wall by the bedroom door. Underneath the medals there is a table with a lamp. South of here the hallway extends to grandma's door. You also see the Hallway door which leads to the stairs, leading down to the kitchen!

You can see Orange door, Wooden stool, Lamp and Medals here.

* * *

>w
(first opening Orange door)

Hallway
There are hallway windows on the side of the Hallway opposite of your door illuminating the objects in the room.  There's a small wooden stool grandma stands on to clean the windows since they're too tall for her.  There's some old medals hanging on the wall by the bedroom door. Underneath the medals there is a table with a lamp. South of here the hallway extends to grandma's door. You also see the Hallway door which leads to the stairs, leading down to the kitchen!

You can see Orange door, Wooden stool, Lamp and Medals here.

>stand on stool
You get onto Wooden stool.

>get off stool
You get off Wooden stool.

Hallway
There are hallway windows on the side of the Hallway opposite of your door illumanting the objects in the room.  There's a small wooden stool grandma stands on to clean the windows since they're to tall for her.  There's some old medals hanging on the wall by the bedroom door. Underneath the medals there is a table with a lamp. South of here the hallway extends to grandmas door. You also see the Hallway door which leads to the stairs, leading down to the kitchen!

You can see Orange door, Wooden stool, Lamp and Medals here.

>climb on stool
You get onto Wooden stool.

* * *

>take spare key
Taken.

>x sheets
These long sheets make it easy to hide something, of course to find anything you'd have to lift the sheets...

>take sheets
I would have to feel around for a key, and I'm too scared to put my hand underneath this dark bed without something to kill any bugs that might jump out.
Cough... cough... These sheets our even dustier than I thought!

>i
You are carrying:
  Sheets
  spare key

* * *

>x bed
It's a stiff bed with long sheets hanging down to the floor

* * *

>x sheets
These long sheets make it easy to hide something, of course to find anything you'd have to lift the sheets...

>lift sheets
I would have to feel around for a key, and I'm too scared to put my hand underneath this dark bed without something to kill any bugs that might jump out.

>x imaginary cookie
I can just imagine breaking off a nice piece with lots of chocolate chunks... theres probably something else that can break like a cookie in this room...

>x records
ohhh nice, some Frank Sinatra

>take records
Taken.

* * *

>x sheets
These long sheets make it easy to hide something, of course to find anything you'd have to lift the sheets...

>take sheets
I would have to feel around for a key, and I'm too scared to put my hand underneath this dark bed without something to kill any bugs that might jump out.

* * *

>x despair
I can just imagine breaking off a nice piece with lots of chocolate chunks... theres probably something else that can break like a cookie in this room...

>take despair
Are you going delusional, the cookies are downstairs, you can't eat dreams!

>x bike horn
The ringer is broken, however it seems like it could still be attached to any poles about as thick as the bedside table's legs with the comand combine.

>take
What do you want to take?

>horn
Taken.

>x window
Closed with a crancking handle, but it's stuck, you probably need a wrench in order to crank it open.

* * *

>take stapler
Taken.

>x records
ohhh nice, some Frank Sinatra

* * *

>take records
Taken.

>x bed
It's a stiff bed with long sheets hanging down to the floor

>take sheets
I would have to feel around for a key, and I'm too scared to put my hand underneath this dark bed without something to kill any bugs that might jump out.

>x orange door
I don't really like orange, also the door is old and faded.

>x table
This table seems really stury, so sturdy you could hang off of it.

>take table
That's hardly portable.

>w
(first opening Orange door)
It seems to be locked.

>down
You gotta open the window before you can get down there!

I beg your pardon?

>combine bike horn with table
You fuse together Broken bike horn and Bedside table.
You have made Hook!

>i
You are carrying:
  Records
  Stapler

>take hook
Taken.

>drop hook
I think you should try stapling something else. You're on the right track though!

>drop records
I think you should try stapling something else. You're on the right track though!

>staple records
I think you should try stapling something else. You're on the right track though!

>x under the bed
You can't see any such thing.

>x under bed
You can't see any such thing.

>break record
You can't see any such thing.

>break records
You shater the record on your bed and quickly clean up all the peices except for one large one which you keep to protect you from the bugs. You should be carefully, thankfully the walls kept you safe, but if you had done something this loud in the hallway, grandma would have waken up.

>take sheets
You feel around under the bed with your disc shard ready, and you feel it... the Spare Key! You now have the spare key!

>i
You are carrying:
  spare key
  Broken disk
  Hook
  Stapler

>unlock door
You can't see any such thing.

I beg your pardon?

>umlock orange door
That's not a verb I recognise.

>unlock orange door
What do you want to unlock Orange door with?

>spare key
You unlock Orange door.

>w
(first opening Orange door)

Hallway
There are hallway windows on the side of the Hallway opposite of your door illumanting the objects in the room.  There's a small wooden stool grandma stands on to clean the windows since their to tall for her.  There's some old medals hanging on the wall by the bedroom door. Underneath the medals there is a table with a lamp. South of here the hallway extends to grandmas door. You also see the Hallway door which leads to the stairs, leading down to the kitchen!

You can see Orange door, Wooden stool, Lamp and Medals here.

>x medals
A bunch of old medals. The long neck straps seem good for tying down things.

* * *

>take medals
You, scared that grabbing to many could make extra noise grab the first medal that you touch on the wall. You now have a medal.

>x stool
Small wooden stool. It can fold in on itself so you can carry it around. Pretty nice!

>take stool
Taken.

>x table
Nice old marble table, nothing much.

>take table
That's hardly portable.

>x lamp
Heavy metal lamp with a switch on the top. It's a really bright lamp, the light will probably leak through to grandma's room if you try and turn it on, so don't.

Lamp is currently switched off.

>e
Bedroom
Completely dark, you lie on your bed. The wall arcross from you has an orange door. To your left is a bedside table   There is also a broken bike horn.   You can feel the despair in the room taking shape as an imaginary cookie that is out of reach. 

You can see Orange door, Window and Despair here.

>w
Hallway
There are hallway windows on the side of the Hallway opposite of your door illumanting the objects in the room.  There's some old medals hanging on the wall by the bedroom door. Underneath the medals there is a table with a lamp. South of here the hallway extends to grandmas door. You also see the Hallway door which leads to the stairs, leading down to the kitchen!

You can see Orange door and Lamp here.

>s
Grandmas entrance
Still part of the hallway you see  the sillouette of a wrench lying against the wall on the groud on the corner between the end of the line of hallway windows and  grandmas door. There is also a spare bell for the broken bike horn in your room and a rubber duck on the floor. The cat likes to play with pretty loud toys.

You can see a wrench, Spare bell and Rubber duck here.

>s
You can't go that way.

>w
You can't go that way.

>n
Hallway
There are hallway windows on the side of the Hallway opposite of your door illumanting the objects in the room.  There's some old medals hanging on the wall by the bedroom door. Underneath the medals there is a table with a lamp. South of here the hallway extends to grandmas door. You also see the Hallway door which leads to the stairs, leading down to the kitchen!

You can see Orange door and Lamp here.

>open window
You can't see any such thing.

>s
Grandmas entrance
Still part of the hallway you see  the sillouette of a wrench lying against the wall on the groud on the corner between the end of the line of hallway windows and  grandmas door. There is also a spare bell for the broken bike horn in your room and a rubber duck on the floor. The cat likes to play with pretty loud toys.

You can see a wrench, Spare bell and Rubber duck here.

>x spare bell
I heard the cat playing with it earlier. It was prettly loud so I wouldn't go near it if I were you.

* * *

>x rubber duck
I heard the cat playing with it earlier. It was prettly loud so I wouldn't go near it if I were you.

>x wrench
This wrench seems really good at cranking things open.

* * *

>take wrench
Taken.

>x window
You can't see any such thing.

>n'
That's not a verb I recognise.

>n
Hallway
There are hallway windows on the side of the Hallway opposite of your door illumanting the objects in the room.  There's some old medals hanging on the wall by the bedroom door. Underneath the medals there is a table with a lamp. South of here the hallway extends to grandmas door. You also see the Hallway door which leads to the stairs, leading down to the kitchen!

You can see Orange door and Lamp here.

>x window
You can't see any such thing.

>x windows
You can't see any such thing.

>x hallway windows
Tall windows. They're never opened and are really dusty.

>open hallway windows
It isn't something you can open.

>e
Bedroom
Completely dark, you lie on your bed. The wall arcross from you has an orange door. To your left is a bedside table   There is also a broken bike horn.   You can feel the despair in the room taking shape as an imaginary cookie that is out of reach. 

You can see Orange door, Window and Despair here.

>open window
It seems to be locked.

>x window
Closed with a crancking handle, but it's stuck, you probably need a wrench in order to crank it open.

>unlock window
What do you want to unlock Window with?

* * *

>wrench
You unlock Window.

>open window
You open Window.

>d
You're gona kill yourself kid! Haven't you seen the movies, at least make a homemade rope out of the sheets and slide down on that.

>take sheets
Cough... cough... These sheets our even dustier than I thought!

>i
You are carrying:
  Sheets
  a wrench
  Wooden stool
  Medal
  spare key
  Broken disk
  Hook
  Stapler

>drop hooks
You can't see any such thing.

>drop hook
I think you should try stapling something else. You're on the right track though!

>staple sheets
I think you should try stapling something else. You're on the right track though!

>i
You are carrying:
  Sheets
  a wrench
  Wooden stool
  Medal
  spare key
  Broken disk
  Hook
  Stapler

>w
Hallway
There are hallway windows on the side of the Hallway opposite of your door illumanting the objects in the room.  There's some old medals hanging on the wall by the bedroom door. Underneath the medals there is a table with a lamp. South of here the hallway extends to grandmas door. You also see the Hallway door which leads to the stairs, leading down to the kitchen!

You can see Orange door and Lamp here.

>x hallway door
Dang it I really wanted to go down stairs this way, I gess I'll have to find another way. What could I use to get downstairs?

>x grandmas door
You can't see any such thing.

>e
Bedroom
Completely dark, you lie on your bed. The wall arcross from you has an orange door. To your left is a bedside table   There is also a broken bike horn.   You can feel the despair in the room taking shape as an imaginary cookie that is out of reach. 

You can see Orange door, Window and Despair here.

>i
You are carrying:
  Sheets
  a wrench
  Wooden stool
  Medal
  spare key
  Broken disk
  Hook
  Stapler

>e
You can't go that way.

>x hook
Now you've made a hook that you can tie things to. This will be super good for climbing out the window. The only problem is you can't attach something as big as a bed sheet to this make shift hook, you have to combine something else to the hook in order to attach your sheets.

>combine hook with sheets
The only problem is you can't attach something as big as a bed sheet to this make shift hook, you have to combine something else to the hook in order to attach your sheets.

>combine hook  with medals
You can't see any such thing.

>combine hook with medal
You fuse together Hook and Medal.
You have made Hanger!

* * *

>combine hanger with sheets
You fuse together Hanger and Sheets.
You have made Homemade rope!

>d
You swing down the outside of the house, feeling the cool night breeze softly landing on the grass outside.

Landing Zone
You are now outside at, there is a cool breeze and moonlight illuminating the grass. To the east you see the woods and the north leads towards the door, which leads to the kitchen... and the cookies!!

You can see Window here.

* * *

>n
Light Zone
Between landing zone and the door to the kitchen.  Wait! There's a motion activated light north of here, it's between you and the door. If you go that way the light will turn on and give you away!

You can see Light here.

>s
Landing Zone
You are now outside at, there is a cool breeze and moonlight illuminating the grass. To the east you see the woods and the north leads towards the door, which leads to the kitchen... and the cookies!!

You can see Window here.

>e
Woods
It's just a plain field.  Oh look it's the cat, he's playing with a pile of leaves. I love the cat. Whats that? Did I just hear the cat speak to me??

You can see Leaves here.

I beg your pardon?

>x cat
Just a regular black cat playing in the leaves. It also talks, wadda ya know!

>talk to cat
"Is that you?" you say hesitantly. 

"Yup it's really me, though I have to point out you are a very imaginative child." the cat replies casually.

>ask cat about light
There is no reply.

>ask cat about leaves
There is no reply.

>talk to cat
 "Umm.... is there anything taht you have to say, you know, as a cat?" 

 "I mean I'm a cat so I'm good at sneaking around, I could give you some pointers" the cat replies in a friendly manner."

>talk to cat
"How do I get to the door of the house" you ask the cat. 

 "Okay I can see your persistance, so I'll give you a hint. Take these leave that I've gathered so nicely for you, and simply staple___" the cat says and then dashes into the bushes!

>take leaves
Taken.

>i
You are carrying:
  Leaves
  a wrench
  Wooden stool
  spare key
  Broken disk
  Stapler

>staple leaves
You staple the leaves to the wall bloking the light from reaching upstairs. Now safely go to the porch up north!

>n
You can't go that way.

>w
Landing Zone
You are now outside at, there is a cool breeze and moonlight illuminating the grass. To the east you see the woods and the north leads towards the door, which leads to the kitchen... and the cookies!!

You can see Window here.

* * *

>n
Light Zone
Between landing zone and the door to the kitchen.  Wait! There's a motion activated light north of here, it's between you and the door. If you go that way the light will turn on and give you away!

You can see Light here.

>n
The light turns on, and grandma's six sence wakes her up... Looks like you'll never even see cookies at grandma's house again.

    *** The End ***

Would you like to RESTART, RESTORE a saved game, QUIT or UNDO the last command?

>undo
Light Zone
[Previous turn undone.]

>undo
Landing Zone
[Previous turn undone.]

>undo
Woods
[Previous turn undone.]

>i
You are carrying:
  a wrench
  Wooden stool
  spare key
  Broken disk
  Stapler

>take leaves
Taken.

>n
You can't go that way.

* * *

>staple leaves
You staple the leaves to the wall bloking the light from reaching upstairs. Now safely go to the porch up north!

>n
The light turns on, but thankfully your leaves dim the light.

Front Porch
Your right in front of outside door now! Lucky for you grandma doesn't lock this door. (She isn't scared of getting robbed, but is scared of you running around in the woods a night)

You can see Outside door here.

>x door
You can't see any such thing.

>x outside door
A really green door.

>open door
You can't see any such thing.

>open outside door
You open Outside door.

>w
Kitchen
You've made it!  However it's really dark and you can't find the cookies. All you have to do is take them, but stubbling around could wake up grandma!  

You can see Outside door here.

>i
You are carrying:
  a wrench
  Wooden stool
  spare key
  Broken disk
  Stapler

>x dark
You can't see any such thing.

>switch light on
You can't see any such thing.

>x outside door
A really green door.

>take cookies
You search the counters feriously feeling for the cookies and then you nock grandmas favorite vase on the floor!!! Right after the falling sound you see an upstairs light turn on... You were so close, you just needed a light!

    *** The End ***

Would you like to RESTART, RESTORE a saved game, QUIT or UNDO the last command?

>undo
Kitchen
[Previous turn undone.]

>s
You can't go that way.

>take leaves
You can't see any such thing.

>e
The light turns on, but thankfully your leaves dim the light.

Front Porch
Your right in front of outside door now! Lucky for you grandma doesn't lock this door. (She isn't scared of getting robbed, but is scared of you running around in the woods a night)

You can see Outside door here.

>e
You can't go that way.

>w
Kitchen
You've made it!  However it's really dark and you can't find the cookies. All you have to do is take them, but stubbling around could wake up grandma!  

You can see Outside door here.

>e
The light turns on, but thankfully your leaves dim the light.

Front Porch
Your right in front of outside door now! Lucky for you grandma doesn't lock this door. (She isn't scared of getting robbed, but is scared of you running around in the woods a night)

You can see Outside door here.

>s
Light Zone
Between landing zone and the door to the kitchen. 

You can see Leaves and Light here.

* * *

>take light
You carefully remove the light under the safety of the leaves...

>s
Landing Zone
You are now outside at, there is a cool breeze and moonlight illuminating the grass. To the east you see the woods and the north leads towards the door, which leads to the kitchen... and the cookies!!

You can see Window here.

>n
Light Zone
Between landing zone and the door to the kitchen. 

You can see Leaves here.

>n
Front Porch
Your right in front of outside door now! Lucky for you grandma doesn't lock this door. (She isn't scared of getting robbed, but is scared of you running around in the woods a night)

You can see Outside door here.

>w
Kitchen
You've made it!   You see the cookies on the top shelf above the sink. To take them however you have to be able to reach them. Now the only question is, how are you going to reach them? 

You can see Outside door here.

>use light
That's not a verb I recognise.

>drop light
I think you should try stapling something else. You're on the right track though!

>switch light on
It isn't something you can switch.

>take cookies
You can see them now, but you cant reach them!

>drop stool
You quietly place down the stool.

>i
You are carrying:
  Light
  a wrench
  spare key
  Broken disk
  Stapler

>e
Front Porch
Your right in front of outside door now! Lucky for you grandma doesn't lock this door. (She isn't scared of getting robbed, but is scared of you running around in the woods a night)

You can see Outside door here.

>w
Kitchen
You've made it!   You see the cookies on the top shelf above the sink. To take them however you have to be able to reach them. Now the only question is, how are you going to reach them? 

You can see Outside door and Wooden stool here.

>e
Front Porch
Your right in front of outside door now! Lucky for you grandma doesn't lock this door. (She isn't scared of getting robbed, but is scared of you running around in the woods a night)

You can see Outside door here.

>s
Light Zone
Between landing zone and the door to the kitchen. 

You can see Leaves here.

>s
Landing Zone
You are now outside at, there is a cool breeze and moonlight illuminating the grass. To the east you see the woods and the north leads towards the door, which leads to the kitchen... and the cookies!!

You can see Window here.

>w
Bedroom
Completely dark, you lie on your bed. The wall arcross from you has an orange door. To your left is a bedside table   There is also a broken bike horn.   You can feel the despair in the room taking shape as an imaginary cookie that is out of reach. 

You can see Window, Homemade rope, Orange door and Despair here.

>take wooden stool
You can't see any such thing.

>d
You swing down the outside of the house, feeling the cool night breeze softly landing on the grass outside.

Landing Zone
You are now outside at, there is a cool breeze and moonlight illuminating the grass. To the east you see the woods and the north leads towards the door, which leads to the kitchen... and the cookies!!

You can see Window here.

>e
Woods
It's just a plain field.

>w
Landing Zone
You are now outside at, there is a cool breeze and moonlight illuminating the grass. To the east you see the woods and the north leads towards the door, which leads to the kitchen... and the cookies!!

You can see Window here.

>w
Bedroom
Completely dark, you lie on your bed. The wall arcross from you has an orange door. To your left is a bedside table   There is also a broken bike horn.   You can feel the despair in the room taking shape as an imaginary cookie that is out of reach. 

You can see Window, Homemade rope, Orange door and Despair here.

>e
You can't go that way.

>n
You can't go that way.

>d
You swing down the outside of the house, feeling the cool night breeze softly landing on the grass outside.

Landing Zone
You are now outside at, there is a cool breeze and moonlight illuminating the grass. To the east you see the woods and the north leads towards the door, which leads to the kitchen... and the cookies!!

You can see Window here.

>i
You are carrying:
  Light
  a wrench
  spare key
  Broken disk
  Stapler

>n
Light Zone
Between landing zone and the door to the kitchen. 

You can see Leaves here.

* * *

>n
Front Porch
Your right in front of outside door now! Lucky for you grandma doesn't lock this door. (She isn't scared of getting robbed, but is scared of you running around in the woods a night)

You can see Outside door here.

>w
Kitchen
You've made it!   You see the cookies on the top shelf above the sink. To take them however you have to be able to reach them. Now the only question is, how are you going to reach them? 

You can see Outside door and Wooden stool here.

>drop stool
You quietly place down the stool.

>take cookies
You can see them now, but you cant reach them!

>climb on stool
You can't see any such thing.

>climb on wooden stool
You can't see any such thing.

>climb on stool
You can't see any such thing.

>climb on stool
You can't see any such thing.

>enter wooden stool
You get onto Wooden stool.

>get off wooden stool
You get off Wooden stool.

Kitchen
You've made it!   You see the cookies on the top shelf above the sink. To take them however you have to be able to reach them. Now the only question is, how are you going to reach them? 

You can see Wooden stool and Outside door here.

>stand on wooden stool
You get onto Wooden stool.

>get off wooden stool
You get off Wooden stool.

Kitchen
You've made it!   You see the cookies on the top shelf above the sink. To take them however you have to be able to reach them. Now the only question is, how are you going to reach them? 

You can see Wooden stool and Outside door here.

>stand on stool
You get onto Wooden stool.

* * *

>x despair
I can just imagine breaking off a nice piece with lots of chocolate chunks... theres probably something else that can break like a cookie in this room...

>x cookie
I can just imagine breaking off a nice piece with lots of chocolate chunks... theres probably something else that can break like a cookie in this room...

>x records
ohhh nice, some Frank Sinatra

>x door
I don't really like orange, also the door is old and faded.

>take stapler
Taken.

>x stapler
Seems like it could be good at hanging things up.

>x window
Closed with a crancking handle, but it's stuck, you probably need a wrench in order to crank it open.

>open door
It seems to be locked.

>x bike horn
The ringer is broken, however it seems like it could still be attached to any poles about as thick as the bedside table's legs with the comand combine.

>take ringer
You can't see any such thing.

>take bike horn
Taken.

>x despair
I can just imagine breaking off a nice piece with lots of chocolate chunks... theres probably something else that can break like a cookie in this room...

>x table
This table seems really stury, so sturdy you could hang off of it.

>x bed
It's a stiff bed with long sheets hanging down to the floor

>x floor
You can't see any such thing.

>x sheets
These long sheets make it easy to hide something, of course to find anything you'd have to lift the sheets...

* * *

>lift sheets
While the long sheets sure look like they could be hidding something useful I am not willing to reveal any bugs or monsters under my bed without some sort of Sharp object like broken glass.

>i
You are carrying:
  Broken bike horn
  Stapler

>x stapler
Seems like it could be good at hanging things up.

>x bedside table
This table seems really stury, so sturdy you could hang off of it.

>x legs
You can't see any such thing.

>combine bedside table with bike horn
You fuse together Bedside table and Broken bike horn.
You have made Hook!

>use hook on sheets
That's not a verb I recognise.

>x sheets
These long sheets make it easy to hide something, of course to find anything you'd have to lift the sheets...

>lift sheets with hook
I only understood you as far as wanting to lift Sheets.

>lift sheets
While the long sheets sure look like they could be hidding something useful I am not willing to reveal any bugs or monsters under my bed without some sort of Sharp object like broken glass.

>i
You are carrying:
  Stapler

>take hook
It's attached to the table, which is gonna be good for getting you down stairs, so I wouldn't undo it

>break window
Violence isn't the answer to this one.

>break records
You shater the record on your bed and quickly clean up all the peices except for one large one which you keep to protect you from the bugs. You should be carefully, thankfully the walls kept you safe, but if you had done something this loud in the hallway, grandma would have waken up.

>i
You are carrying:
  Broken disk
  Stapler

I beg your pardon?

>x sheets
These long sheets make it easy to hide something, of course to find anything you'd have to lift the sheets...

>lift sheet
You can't see any such thing.

>lift sheets
You feel around under the bed with your disc shard ready, and you feel it... the Spare Key! You now have the spare key!

>take key
You already have that.

>i
You are carrying:
  spare key
  Broken disk
  Stapler

>open door with key
You unlock Orange door.

>west
(first opening Orange door)

Hallway
There are hallway windows on the side of the Hallway opposite of your door illumanting the objects in the room.  There's a small wooden stool grandma stands on to clean the windows since they're to tall for her.  There's some old medals hanging on the wall by the bedroom door. Underneath the medals there is a table with a lamp. South of here the hallway extends to grandmas door. You also see the Hallway door which leads to the stairs, leading down to the kitchen!

You can see Orange door, Wooden stool, Lamp and Medals here.

>x medals
A bunch of old medals. The long neck straps seem good for tying down things.

* * *

>x table
Nice old marble table, nothing much.

>x lamp
Heavy metal lamp with a switch on the top. It's a really bright lamp, the light will probably leak through to grandma's room if you try and turn it on, so don't.

Lamp is currently switched off.

>x wooden stool
Small wooden stool. It can fold in on itself so you can carry it around. Pretty nice!

>take stool
Taken.

>south
Grandmas entrance
Still part of the hallway you see  the sillouette of a wrench lying against the wall on the ground on the corner between the end of the line of hallway windows and  grandmas door. There is also a spare bell for the broken bike horn in your room and a rubber duck on the floor. The cat likes to play with pretty loud toys.

You can see a wrench, Spare bell and Rubber duck here.

>take wrench
Taken.

* * *

>take bell
you reach for the bell and in the process of picking it up it rings alerting grandma. Your in big trouble for sneaking around a night!

    *** The End ***

Would you like to RESTART, RESTORE a saved game, QUIT or UNDO the last command?

>undo
Grandmas entrance
[Previous turn undone.]

>x bell
I heard the cat playing with it earlier. It was prettly loud so I wouldn't go near it if I were you.

>x rubber duck
I heard the cat playing with it earlier. It was prettly loud so I wouldn't go near it if I were you.

>north
Hallway
There are hallway windows on the side of the Hallway opposite of your door illumanting the objects in the room.  There's some old medals hanging on the wall by the bedroom door. Underneath the medals there is a table with a lamp. South of here the hallway extends to grandmas door. You also see the Hallway door which leads to the stairs, leading down to the kitchen!

You can see Orange door and Lamp here.

>east
Bedroom
Completely dark, you lie on your bed. The wall arcross from you has an orange door. To your left is a bedside table   There is also a broken bike horn.   You can feel the despair in the room taking shape as an imaginary cookie that is out of reach. 

You can see Orange door, Hook, Window and Despair here.

>west
Hallway
There are hallway windows on the side of the Hallway opposite of your door illumanting the objects in the room.  There's some old medals hanging on the wall by the bedroom door. Underneath the medals there is a table with a lamp. South of here the hallway extends to grandmas door. You also see the Hallway door which leads to the stairs, leading down to the kitchen!

You can see Orange door and Lamp here.

>south
Grandmas entrance
Still part of the hallway you see  grandmas door. There is also a spare bell for the broken bike horn in your room and a rubber duck on the floor. The cat likes to play with pretty loud toys.

You can see Spare bell and Rubber duck here.

>north
Hallway
There are hallway windows on the side of the Hallway opposite of your door illumanting the objects in the room.  There's some old medals hanging on the wall by the bedroom door. Underneath the medals there is a table with a lamp. South of here the hallway extends to grandmas door. You also see the Hallway door which leads to the stairs, leading down to the kitchen!

You can see Orange door and Lamp here.

* * *

>west
Hallway
There are hallway windows on the side of the Hallway opposite of your door illumanting the objects in the room.  There's some old medals hanging on the wall by the bedroom door. Underneath the medals there is a table with a lamp. South of here the hallway extends to grandmas door. You also see the Hallway door which leads to the stairs, leading down to the kitchen!

You can see Orange door and Lamp here.

>north
You can't go that way.

>x door
I don't really like orange, also the door is old and faded.

>x hallway door
Dang it I really wanted to go down stairs this way, I gess I'll have to find another way. What could I use to get downstairs?

>i
You are carrying:
  a wrench
  Wooden stool
  Medal
  spare key
  Broken disk
  Stapler

>south
Grandmas entrance
Still part of the hallway you see  grandmas door. There is also a spare bell for the broken bike horn in your room and a rubber duck on the floor. The cat likes to play with pretty loud toys.

You can see Spare bell and Rubber duck here.

* * *

>east
Bedroom
Completely dark, you lie on your bed. The wall arcross from you has an orange door. To your left is a bedside table   There is also a broken bike horn.   You can feel the despair in the room taking shape as an imaginary cookie that is out of reach. 

You can see Orange door, Hook, Window and Despair here.

>use table
That's not a verb I recognise.

>x table
You can't see any such thing.

>i
You are carrying:
  a wrench
  Wooden stool
  Medal
  spare key
  Broken disk
  Stapler

>x hook
Now you've made a hook that you can tie things to. This will be super good for climbing out the window. The only problem is you can't attach something as big as a bed sheet to this make shift hook, you have to combine something else to the hook in order to attach your sheets.

>i
You are carrying:
  a wrench
  Wooden stool
  Medal
  spare key
  Broken disk
  Stapler

>combine medal with hook
You fuse together Medal and Hook.
You have made Hanger!

>x hanger
Great now you have a big enough loop to attach all your sheets to!

* * *

>take sheets
Cough... cough... These sheets our even dustier than I thought!

>i
You are carrying:
  Sheets
  a wrench
  Wooden stool
  spare key
  Broken disk
  Stapler

>combine sheets with hanger
You fuse together Sheets and Hanger.
You have made Homemade rope!

>x rope
Just like in the movies you have made your own escape line! Good Job!

>use rope
That's not a verb I recognise.

>down
You gotta open the window before you can get down there!

>open window
It seems to be locked.

>open window with key
That doesn't seem to fit the lock.

>x window
Closed with a crancking handle, but it's stuck, you probably need a wrench in order to crank it open.

>use wrench on window
That's not a verb I recognise.

>use wrench to open window
That's not a verb I recognise.

>crank window open
I didn't understand that sentence.

>open window with wrench
You unlock Window.

>down
You gotta open the window before you can get down there!

>open window
You open Window.

>down
You swing down the outside of the house, feeling the cool night breeze softly landing on the grass outside.

Landing Zone
You are now outside at, there is a cool breeze and moonlight illuminating the grass. To the east you see the woods and the north leads towards the door, which leads to the kitchen... and the cookies!!

You can see Window here.

>north
Light Zone
Between landing zone and the door to the kitchen.  Wait! There's a motion activated light north of here, it's between you and the door. If you go that way the light will turn on and give you away!

You can see Light here.

>south
Landing Zone
You are now outside at, there is a cool breeze and moonlight illuminating the grass. To the east you see the woods and the north leads towards the door, which leads to the kitchen... and the cookies!!

You can see Window here.

>east
Woods
It's just a plain field.  Oh look it's the cat, he's playing with a pile of leaves. I love the cat. Whats that? Did I just hear the cat speak to me??

You can see Leaves here.

>x leaves
Large thick leaves that look like they come from a thick jungle plant and leave you wondering where the cat goes in his free time. They are thick enough to block light, but thin enough that if you really tried to you could probably staple them up.

>talk to cat
"Is that you?" you say hesitantly. 

"Yup it's really me, though I have to point out you are a very imaginative child." the cat replies casually.

>i
You are carrying:
  a wrench
  Wooden stool
  spare key
  Broken disk
  Stapler

>g
You are carrying:
  a wrench
  Wooden stool
  spare key
  Broken disk
  Stapler

>talk to cat
 "Umm.... is there anything taht you have to say, you know, as a cat?" 

 "I mean I'm a cat so I'm good at sneaking around, I could give you some pointers" the cat replies in a friendly manner."

>g
"How do I get to the door of the house" you ask the cat. 

 "Okay I can see your persistance, so I'll give you a hint. Take these leave that I've gathered so nicely for you, and simply staple___" the cat says and then dashes into the bushes!

>i
You are carrying:
  a wrench
  Wooden stool
  spare key
  Broken disk
  Stapler

* * *

>i
You are carrying:
  Leaves
  a wrench
  Wooden stool
  spare key
  Broken disk
  Stapler

>x leaves
Large thick leaves that look like they come from a thick jungle plant and leave you wondering where the cat goes in his free time. They are thick enough to block light, but thin enough that if you really tried to you could probably staple them up.

>combine staple with leaves
You can't see any such thing.

>combine stapler with leaves
You can't combine Stapler and Leaves into anything useful.
Try another combination of things.

>west
Landing Zone
You are now outside at, there is a cool breeze and moonlight illuminating the grass. To the east you see the woods and the north leads towards the door, which leads to the kitchen... and the cookies!!

You can see Window here.

>staple leaves
what are stapled leaves over here gonna do for you? The cat obviously meant for you to staple them somewhere useful.
I think you should try stapling something else. You're on the right track though!

>north
Light Zone
Between landing zone and the door to the kitchen.  Wait! There's a motion activated light north of here, it's between you and the door. If you go that way the light will turn on and give you away!

You can see Light here.

>staple leaves
You staple the leaves to the wall bloking the light from reaching upstairs. Now safely go to the porch up north!
I think you should try stapling something else. You're on the right track though!

>north
The light turns on, but thankfully your leaves dim the light.

Front Porch
Your right in front of outside door now! Lucky for you grandma doesn't lock this door. (She isn't scared of getting robbed, but is scared of you running around in the woods a night)

You can see Outside door here.

>west
(first opening Outside door)

Kitchen
You've made it!  However it's really dark and you can't find the cookies. All you have to do is take them, but stumbling around could wake up grandma!  

You can see Outside door here.

>i
You are carrying:
  a wrench
  Wooden stool
  spare key
  Broken disk
  Stapler

>find light
That's not a verb I recognise.

>use wooden stool
That's not a verb I recognise.

>x wooden stool
Small wooden stool. It can fold in on itself so you can carry it around. Pretty nice!

>open wooden stool
It isn't something you can open.

>east
The light turns on, but thankfully your leaves dim the light.

Front Porch
Your right in front of outside door now! Lucky for you grandma doesn't lock this door. (She isn't scared of getting robbed, but is scared of you running around in the woods a night)

You can see Outside door here.

>south
Light Zone
Between landing zone and the door to the kitchen. 

You can see Leaves and Light here.

>x light
Motion activated, and bright enough to take up grandma. Advance with caution.

>take light
You carefully remove the light under the safety of the leaves...

>north
Front Porch
Your right in front of outside door now! Lucky for you grandma doesn't lock this door. (She isn't scared of getting robbed, but is scared of you running around in the woods a night)

You can see Outside door here.

>west
Kitchen
You've made it!   You see the cookies on the top shelf above the sink. To take them however you have to be able to reach them. Now the only question is, how are you going to reach them? 

You can see Outside door here.

>get on stool
You can only get into something free-standing.

>drop stool
You quietly place down the stool.

* * *

>x despair
I can just imagine breaking off a nice piece with lots of chocolate chunks... theres probably something else that can break like a cookie in this room...

>x records
ohhh nice, some Frank Sinatra

>x bed
It's a stiff bed with long sheets hanging down to the floor

* * *

>lift sheets
I would have to feel around for a key, and I'm too scared to put my hand underneath this dark bed without something to kill any bugs that might jump out.

>x records
ohhh nice, some Frank Sinatra

>take broken disc
You can't see any such thing.

>take disc
You can't see any such thing.

>take broken disk
Taken.

* * *

>lift sheets
You feel around under the bed with your disc shard ready, and you feel it... the Spare Key! You now have Spare!

>unlock orange
What do you want to unlock Orange with?

>unlock orange with spare
You unlock Orange.

>open orange
You open Orange.

    *** The End ***

Would you like to RESTART, RESTORE a saved game, QUIT or UNDO the last command?

* * *

>x i
You can't see any such thing.

>x myself
You are a small seven year old who has one desire cookies. You hae orange curly hair and are pretty coordinated

* * *

>x imaginary cookie
I can just imagine breaking of a nice piece with lots of chocolate chunks... theres probably something else that can break like a cookie in this room...

* * *

>x orange door
I don't really like orange, also the door is old and faded.

>x orange
what a stupid color. The door is old and faded.

* * *

>x records
ohhh nice, some Frank Sinatra

>x imaginary cookie
I only understood you as far as wanting to examine Imaginary cookies.

>x imaginary cookie
I only understood you as far as wanting to examine Imaginary cookies.

* * *

>x stapler
Sorry, this is for the next puzzle.

>x broken bike horn
Sorry, this is for the next puzzle.

>x records
ohhh nice, some Frank Sinatra

>x orange door
I don't really like orange, also the door is old and faded.

>x bed
It's a stiff bed with long sheets hanging down to the floor

>i
You are carrying nothing.

>take records
Taken.

>x sheets
These long sheets make it easy to hide something, of course to find anything you'd have to lift the sheets...

* * *

>lift sheets
I would have to feel around for a key, and I'm too scared to put my hand underneath this dark bed without something to kill any bugs that might jump out.

>x window
You can't see any such thing.

>x bedside table
I only understood you as far as wanting to examine Bedside tabel.

>x bedside tabel
Sorry, this is for the next puzzle.

>x cookie
I can just imagine breaking off a nice piece with lots of chocolate chunks... theres probably something else that can break like a cookie in this room...

>break records
You shater the record on your bed and quickly clean up all the peices except for one large one which you keep to protect you from the bugs. You should be carefully, thankfully the walls kept you safe, but if you had done something this loud in the hallway, grandma would have waken up.

>lift sheets
You feel around under the bed with your disc shard ready, and you feel it... the Spare Key! You now have Spare!

>unlock door
You can't see any such thing.

>unlock orange door
What do you want to unlock Orange door with?

>spare
You unlock Orange door.